################
#              #
# ############ #
# #          # #
# # ###  ### # #
# # #      # # #
# # #      # # #
#   #  ##  #   #
#   #  ##  #   #
# # #      # # #
# # #      # # #
# # ###  ### # #
# #          # #
# ############ #
#              #
################
