################
#              #
# # # # # # #  #
#              #
#              #
##            ##
#              #
##            ##
#              #
##            ##
#              #
#              #
#              #
#  # # # # # # #
#              #
################
